XXXXXXXXXXXX
XXXXXXXXXXXX
X        JBX
X  B    XX
X         BB
X         BB
X    E    LB
X          B
X      E   X
XXXXXXXXXXXX
XXXXXXXXXXXX
XXXXXXXXXXXX